111111111111111
10C000000000001
10C111111111C01
101000000000101
1010C11111C0101
101010000010101
101010111110101
1010101C0000101
101010111111C01
101010000000101
101010111110101
1010100000101E1
1010C11111C0101
1C10000000000P1
101000000000001
111111111111111