1111111111111111111
11P00000000C00001C1
1011110C11011101101
10000101100C1000001
11101000C1000111011
11110C0111111111111
10000000000C0000C01
111111111111100C111
1E0000000C000C00001
1111111111111111111