111111111111111
1E0001C00000001
100011000000001
1011100100001C1
1P0000001001011
100000000100011
1000000000000C1
111111111111111